#####################
#   #   # #     #   #
### # # # ### # ### #
# # # #   # # #     #
# # ##### # ##### # #
# #   #   #       # #
# ### # # ### # # # #
#       # #   # # # #
######### ##### ### #
#     # # # #   #   #
# ### # # # # # ### #
#   # #       # # # #
# ### ### ### # # ###
# # #     #   #   # #
# # ### # # ####### #
#   #   # #     # # #
# ########### ### # #
# #       # #       #
# ##### # # # # ### #
#     # #     # #   # 
#####################