###############
#             #
#             #
#   #         #
#   #         #
#   #         #
# ###   #     #
#       #     #
#       #     #
#     ###   # #
#           # #
#           # #
#         ### #
#             #
#             #
###############