##########
#  #  #  #
# ## ## ##
#  #  #  #
# ## ## ##
#  #  #  #
# ## ## ##
#  #  #  #
# ## ## ##
#        #
##########